:	Çø
;	Çµ
a	Ç©
b	Ç·
c	Ç…
d,	Ç‰
d.	Çﬁ
d:	ÇÎ
d;	ÇË
da	ÇÏ
df	Ç£
dh	Ç‚
di	Ç–
dj	ÇÍ
dk	Çª
dl	Ç±
dm	ÇÌ
dn	Ç¶
do	Ç›
ds	Ç•
du	Ç÷
dy	Ç 
e	ÇΩ
f	Ç∆
g	Çƒ
h	Ç§
i	Ç¢
j	ÇÒ
k;	Çß
ka	Ç®
kb	Çﬂ
kc	ÇŸ
kd	Ç∑
ke	Ç‡
kf	Ç†
kg	ÇÁ
kj	Çü
kl	Ç°
kr	Çπ
ks	ÇÕ
kt	ÇÊ
kv	ÇØ
kw	Ç≥
kx	Å[
kz	ÇÀ
la	Ç™
lb	Ç’
lc	Ç⁄
ld	Ç∏
le	Çæ
lf	Ç«
lg	Ç≈
lj	Éï
lk	Éñ
lq	ÇÓ
lr	Ç∫
ls	ÇŒ
lt	Ç‘
lv	Ç∞
lw	Ç¥
lx	Çœ
lz	Ç€
m	ÇÈ
n	Ç≠
o	Ç´
q	ÅE
r	Ç‹
s,	Ç“
s.	ÇÔ
s:	Ç¿
s;	Ç∂
sd	ÅJ
sf	ÅK
sh	Éî
si	Ç—
sj	Ç
sk	Çº
sl	Ç≤
sm	Çÿ
sn	ÇÆ
so	Ç¨
su	Ç◊
sy	Ç√
t	Ç”
u	Ç¡
v	Ç»
w	ÇÃ
x	Ç„
y	Ç¬
z	ÇÂ
